"filename", "language", "PHP", "comment", "blank", "total"
"d:\桌面\works_pro\app\admin\controller\Account.php", "PHP", 0, 0, -1, -1
"d:\桌面\works_pro\app\common\business\admin\Account.php", "PHP", 3, 1, 0, 4
"d:\桌面\works_pro\app\common\business\admin\Classes.php", "PHP", 0, 0, 1, 1
"d:\桌面\works_pro\app\common\business\home\DisWork.php", "PHP", 56, 10, 18, 84
"d:\桌面\works_pro\app\common\business\home\Work.php", "PHP", 98, 25, 36, 159
"d:\桌面\works_pro\app\common\model\Account.php", "PHP", 17, 6, 7, 30
"d:\桌面\works_pro\app\common\model\AdminIp.php", "PHP", 11, 3, 6, 20
"d:\桌面\works_pro\app\common\model\admin\Account.php", "PHP", 0, -9, -1, -10
"d:\桌面\works_pro\app\common\model\home\Account.php", "PHP", 0, 0, -1, -1
"d:\桌面\works_pro\app\common\model\home\Score.php", "PHP", 73, 35, 18, 126
"d:\桌面\works_pro\app\common\model\home\Stu.php", "PHP", 18, 6, 7, 31
"d:\桌面\works_pro\app\common\model\home\Work.php", "PHP", 88, 42, 20, 150
"d:\桌面\works_pro\app\common\validate\admin\AdminDoLogin.php", "PHP", 20, 18, 5, 43
"d:\桌面\works_pro\app\common\validate\admin\DoLogin.php", "PHP", -22, -18, -5, -45
"d:\桌面\works_pro\app\home\controller\DisWork.php", "PHP", -32, 0, 0, -32
"d:\桌面\works_pro\app\home\controller\UpWork.php", "PHP", -11, -4, 0, -15
"d:\桌面\works_pro\app\home\route\BaseRoute.php", "PHP", 0, 0, 1, 1
"d:\桌面\works_pro\app\home\route\DisWorkRoute.php", "PHP", 5, 3, 3, 11
"d:\桌面\works_pro\app\home\route\ScoreRoute.php", "PHP", -3, -3, -2, -8
"d:\桌面\works_pro\app\home\route\StuRoute.php", "PHP", -9, -3, -3, -15
"d:\桌面\works_pro\app\home\route\UpWorkRoute.php", "PHP", 7, 3, 3, 13
"d:\桌面\works_pro\app\home\route\WorkRoute.php", "PHP", -8, -3, -3, -14
"d:\桌面\works_pro\app\home\view\dis_work\display.php", "PHP", 6, 0, 0, 6
"d:\桌面\works_pro\app\home\view\dis_work\index.php", "PHP", 1, 0, 0, 1
"d:\桌面\works_pro\app\home\view\up_work\details.php", "PHP", 17, 0, 0, 17
"Total", "-", 335, 112, 109, 556